,row_letter,row,column,x_coord,y_coord,radius,hough_peak_int,min_griddist,note,halo_rad,x+y,x-y,spot_intensity
0,A,1,1,87,86,23,0.37499999999999956,6.0138350603348885,kept,,173,1,0.796492610439333
1,A,1,2,190,88,23,0.31617647058823506,4.676991790992686,kept,,278,102,0.7978826357951735
2,A,1,3,297,89,24,0.45833333333333265,3.032048581512665,kept,,386,208,0.7997716964168461
3,A,1,4,403,89,23,0.4632352941176463,3.048981828186706,kept,,492,314,0.8002323443545374
4,A,1,5,509,93,24,0.4722222222222215,1.826416065043184,kept,,602,416,0.8005919730076473
5,A,1,6,612,95,23,0.43382352941176405,3.897433164896322,kept,,707,517,0.8020628137911529
6,A,1,7,717,92,22,0.484375,1.5038102182174953,kept,,809,625,0.829077390873918
7,A,1,8,822,93,30,0.6704545454545466,1.819287281644434,kept,42.0,915,729,0.9112464769524503
8,A,1,9,932,98,20,0.3833333333333337,6.486257420755284,kept,41.0,1030,834,0.8512066753543253
9,A,1,10,1031,92,23,,0,backfilled,40.0,1123,939,0.83188370659959
10,A,1,11,1156,91,29,0.30357142857142855,3.1622776601683795,kept,40.0,1247,1065,0.8375104807507754
11,A,1,12,1260,100,21,0.4296875,8.06225774829855,kept,48.0,1360,1160,0.8233799032235255
12,A,1,13,1366,99,20,0.4000000000000004,7.280109889280518,kept,47.0,1465,1267,0.8134456667777881
13,A,1,14,1470,94,21,0.3125,2.8284271247461903,kept,59.0,1564,1376,0.807501692073017
14,A,1,15,1578,92,23,0.43382352941176405,2.0,kept,52.0,1670,1486,0.8028972330817955
15,A,1,16,1680,95,21,0.453125,5.0,kept,58.0,1775,1585,0.8006242991787134
16,A,1,17,1784,93,23,0.36029411764705843,7.0710678118654755,kept,59.0,1877,1691,0.8017213686092677
17,A,1,18,1895,91,20,0.4250000000000005,2.23606797749979,kept,47.0,1986,1804,0.8133244436362903
18,A,1,19,2002,92,23,,0,backfilled,40.0,2094,1910,0.8374559303371014
19,A,1,20,2111,85,26,0.5328947368421056,7.615773105863909,kept,44.0,2196,2026,0.8576597872533868
20,B,2,1,83,207,23,0.39705882352941124,8.313293387348045,kept,,290,-124,0.7979836550797549
21,B,2,2,186,211,22,0.4375,5.855789558668388,kept,,397,-25,0.7995252093624674
22,B,2,3,297,209,26,0.40131578947368446,6.2381767335583005,kept,,506,88,0.8014061884413737
23,B,2,4,402,211,24,0.3749999999999996,4.342866608444114,kept,,613,191,0.8012425372003517
24,B,2,5,506,213,25,0.4374999999999994,2.1109323704114633,kept,,719,293,0.8025780121425181
25,B,2,6,610,211,22,0.609375,4.634679938324005,kept,,821,399,0.8054004909537231
26,B,2,7,715,218,22,0.40625,3.292568491963145,kept,,933,497,0.8063541130001719
27,B,2,8,818,215,25,0.5833333333333323,3.3728316766570288,kept,,1033,603,0.8109141235061775
28,B,2,9,925,216,24,0.49999999999999917,2.5898297301702287,kept,,1141,709,0.816193391318403
29,B,2,10,1028,218,24,0.5347222222222213,3.3125013118265496,kept,,1246,810,0.8178379852713885
30,B,2,11,1158,219,23,0.4264705882352935,4.123105625617661,kept,,1377,939,0.8274812861775314
31,B,2,12,1257,217,22,0.4765625,4.47213595499958,kept,,1474,1040,0.8188784839025771
32,B,2,13,1365,216,22,0.484375,3.1622776601683795,kept,,1581,1149,0.8184804679213263
33,B,2,14,1476,215,20,0.40833333333333377,4.0,kept,,1691,1261,0.8218666343404957
34,B,2,15,1581,215,20,0.4583333333333339,1.0,kept,,1796,1366,0.8223151599640374
35,B,2,16,1686,212,24,0.36111111111111077,3.605551275463989,kept,,1898,1474,0.8653857421381743
36,B,2,17,1792,213,25,0.49999999999999917,2.23606797749979,kept,,2005,1579,0.8896546150660163
37,B,2,18,1901,216,23,0.4632352941176463,4.123105625617661,kept,,2117,1685,0.9071713590124357
38,B,2,19,2004,209,30,0.45454545454545425,6.324555320336759,kept,44.0,2213,1795,0.9965067531391744
39,B,2,20,2108,215,23,,0,backfilled,41.0,2323,1893,0.9593801456698086
40,C,3,1,84,326,22,0.4609375,9.038549208253132,kept,,410,-242,0.7983412633471731
41,C,3,2,188,335,23,,0,backfilled,,523,-147,0.8004182198381673
42,C,3,3,295,328,26,0.4605263157894741,7.2281979780232115,kept,,623,-33,0.8028972330817955
43,C,3,4,397,332,24,0.4374999999999994,3.2363596375691013,kept,,729,65,0.8030750270226588
44,C,3,5,500,331,24,0.39583333333333287,5.141349038036883,kept,,831,169,0.80442868543605
45,C,3,6,610,333,23,0.43382352941176405,2.0151195283343193,kept,,943,277,0.807103676091766
46,C,3,7,714,336,24,0.48611111111111033,1.0338105626995782,kept,,1050,378,0.8079239526825672
47,C,3,8,819,333,27,0.4437499999999994,2.019259401447793,kept,,1152,486,0.8086775565455447
48,C,3,9,919,338,23,0.49264705882352855,6.972739919095564,kept,,1257,581,0.8104130678546537
49,C,3,10,1028,335,26,0.3684210526315791,0.690091881596345,kept,,1363,693,0.8100635411300018
50,C,3,11,1156,341,23,0.45588235294117574,6.708203932499369,kept,,1497,815,0.8101584992575085
51,C,3,12,1263,338,25,0.38194444444444403,3.605551275463989,kept,,1601,925,0.8030911901081917
52,C,3,13,1372,338,21,0.390625,5.0,kept,,1710,1034,0.8005374225939734
53,C,3,14,1474,336,23,0.41911764705882293,2.23606797749979,kept,,1810,1138,0.801224353729127
54,C,3,15,1573,334,20,0.39166666666666705,7.0710678118654755,kept,,1907,1239,0.799870695315736
55,C,3,16,1686,337,22,0.4453125,2.8284271247461903,kept,,2023,1349,0.802056752634078
56,C,3,17,1787,334,25,0.42361111111111055,4.123105625617661,kept,,2121,1453,0.8027598468547648
57,C,3,18,1894,333,25,0.48611111111111033,3.605551275463989,kept,,2227,1561,0.8052408804840845
58,C,3,19,1998,334,26,0.4671052631578952,4.123105625617661,kept,,2332,1664,0.8064389691992203
59,C,3,20,2106,332,25,0.35416666666666635,3.605551275463989,kept,,2438,1774,0.8026022567708178
60,D,4,1,81,455,23,,0,backfilled,,536,-374,0.797710903011385
61,D,4,2,191,447,22,0.4453125,9.387900977343053,kept,,638,-256,0.7994989443484762
62,D,4,3,293,451,24,0.42361111111111055,4.426821018323588,kept,,744,-158,0.8016082270105365
63,D,4,4,396,453,25,0.5069444444444436,2.0035660461249813,kept,,849,-57,0.8053176551403665
64,D,4,5,502,452,24,0.43055555555555497,3.122081690705337,kept,,954,50,0.8047095190471864
65,D,4,6,612,453,23,0.4411764705882346,4.336911431523955,kept,,1065,159,0.8081562970371046
66,D,4,7,710,455,26,0.4342105263157898,2.1676216492745652,kept,,1165,255,0.8084553141194656
67,D,4,8,817,456,25,0.4791666666666659,1.0167176943151652,kept,,1273,361,0.8088270650867253
68,D,4,9,922,456,25,0.4097222222222217,1.5618677715882867,kept,,1378,466,0.8088533301007165
69,D,4,10,1025,458,24,0.46527777777777707,3.0077157829179697,kept,,1483,567,0.8076552413855806
70,D,4,11,1160,461,22,0.40625,6.082762530298219,kept,,1621,699,0.805287349354992
71,D,4,12,1264,458,24,0.4722222222222215,4.242640687119285,kept,,1722,806,0.8028649069107294
72,D,4,13,1365,458,25,0.49999999999999917,4.242640687119285,kept,,1823,907,0.7989615217545031
73,D,4,14,1473,459,22,0.5703125,4.123105625617661,kept,,1932,1014,0.7991069895243004
74,D,4,15,1578,456,24,0.3402777777777775,2.23606797749979,kept,,2034,1122,0.7976038225697287
75,D,4,16,1683,457,25,0.39583333333333287,2.23606797749979,kept,,2140,1226,0.7998343283732866
76,D,4,17,1791,455,23,,0,backfilled,,2246,1336,0.7988544413128468
77,D,4,18,1897,455,23,,0,backfilled,,2352,1442,0.7973229889585923
78,D,4,19,1998,453,24,0.4374999999999994,4.47213595499958,kept,,2451,1545,0.7985150165166531
79,D,4,20,2105,452,23,0.36029411764705843,4.242640687119285,kept,,2557,1653,0.7962764291703288
80,E,5,1,79,568,25,0.3680555555555552,8.000102819967175,kept,,647,-489,0.7968481983210597
81,E,5,2,185,569,25,0.5069444444444436,7.074583732824371,kept,,754,-384,0.7993979250638948
82,E,5,3,289,570,26,0.4342105263157898,6.000006122281505,kept,,859,-281,0.8038488347425524
83,E,5,4,394,572,25,0.5486111111111102,4.000006887853458,kept,,966,-178,0.8066995989534405
84,E,5,5,498,572,24,0.49999999999999917,4.128847724758445,kept,,1070,-74,0.8084229879483995
85,E,5,6,602,573,23,0.4999999999999991,5.03182976913322,kept,,1175,29,0.809334181895324
86,E,5,7,708,575,25,0.7291666666666651,2.2858963124595615,kept,,1283,133,0.809758462890566
87,E,5,8,814,577,26,0.5855263157894738,1.465682892357006,kept,,1391,237,0.8080209311957655
88,E,5,9,922,576,24,0.5138888888888881,0.9122999897751924,kept,,1498,346,0.8084048044771749
89,E,5,10,1024,578,25,0.5069444444444436,2.1918446646491536,kept,,1602,446,0.8090897152266369
90,E,5,11,1159,580,25,0.38888888888888845,4.0,kept,,1739,579,0.803753876615046
91,E,5,12,1265,579,24,0.43055555555555497,5.0,kept,,1844,686,0.8009334181895326
92,E,5,13,1367,577,25,0.45138888888888823,1.4142135623730951,kept,,1944,790,0.7990625410390845
93,E,5,14,1471,575,27,0.4499999999999994,1.4142135623730951,kept,,2046,896,0.7981372043923186
94,E,5,15,1578,579,25,0.3749999999999996,3.605551275463989,kept,,2157,999,0.7974704771140811
95,E,5,16,1682,577,26,0.3157894736842105,2.23606797749979,kept,,2259,1105,0.7971148892323546
96,E,5,17,1788,575,25,0.43055555555555497,3.1622776601683795,kept,,2363,1213,0.7974199674717904
97,E,5,18,1893,577,28,0.4880952380952374,4.123105625617661,kept,,2470,1316,0.7964138153973594
98,E,5,19,2002,576,23,,0,backfilled,,2578,1426,0.7947106302593168
99,E,5,20,2108,576,23,,0,backfilled,,2684,1532,0.7952379509248317
100,F,6,1,76,690,23,0.36029411764705843,6.06200745614638,kept,,766,-614,0.7970663999757556
101,F,6,2,181,696,23,,0,backfilled,,877,-515,0.7987574627996485
102,F,6,3,287,690,24,0.5486111111111102,6.0008870950627164,kept,,977,-403,0.8043781757937591
103,F,6,4,391,692,24,0.5416666666666657,4.102832173558938,kept,,1083,-301,0.8073622854602945
104,F,6,5,495,690,26,0.4144736842105266,6.3024048730662,kept,,1185,-195,0.8095261185360286
105,F,6,6,603,695,24,0.45833333333333265,1.3759472390032657,kept,,1298,-92,0.8089886959420555
106,F,6,7,706,696,25,0.5486111111111102,1.9609510015741307,kept,,1402,10,0.8107120849370146
107,F,6,8,812,694,26,0.4868421052631584,2.2258531858189907,kept,,1506,118,0.8107827984362216
108,F,6,9,918,697,25,0.562499999999999,1.409337488012697,kept,,1615,221,0.8095685466355529
109,F,6,10,1022,698,25,0.5138888888888881,2.2322220124196703,kept,,1720,324,0.8073360204463034
110,F,6,11,1158,701,26,0.4407894736842109,5.0990195135927845,kept,,1859,457,0.8031639239930906
111,F,6,12,1260,698,25,0.48611111111111033,2.23606797749979,kept,,1958,562,0.7990625410390845
112,F,6,13,1367,697,25,0.38888888888888845,1.4142135623730951,kept,,2064,670,0.7966623228374298
113,F,6,14,1473,700,24,0.4027777777777773,4.123105625617661,kept,,2173,773,0.7967310159509453
114,F,6,15,1572,698,24,0.38888888888888845,8.246211251235321,kept,,2270,874,0.7962683476275623
115,F,6,16,1687,698,23,0.39705882352941124,3.605551275463989,kept,,2385,989,0.7972058065884778
116,F,6,17,1795,694,20,0.3000000000000001,4.47213595499958,kept,,2489,1101,0.7971371134749625
117,F,6,18,1899,692,20,0.33333333333333354,4.47213595499958,kept,,2591,1207,0.7972280308310857
118,F,6,19,1999,694,25,0.38194444444444403,3.605551275463989,kept,,2693,1305,0.7964279580972009
119,F,6,20,2105,695,22,0.3359375,3.1622776601683795,kept,,2800,1410,0.7932882787324101
120,G,7,1,74,814,23,,0,backfilled,,888,-740,0.7952157266822237
121,G,7,2,182,812,21,0.4453125,2.9576138616031002,kept,,994,-630,0.7972340919881605
122,G,7,3,284,814,23,,0,backfilled,,1098,-530,0.8005778303078059
123,G,7,4,390,811,26,0.4144736842105266,3.0035935837703285,kept,,1201,-421,0.8076572617712723
124,G,7,5,493,814,25,0.45833333333333265,1.8691121227799954,kept,,1307,-321,0.8089058601286988
125,G,7,6,601,811,25,0.3055555555555554,3.12793111091995,kept,,1412,-210,0.8066854562535989
126,G,7,7,706,815,23,0.367647058823529,1.004863624006944,kept,,1521,-109,0.8092796314816499
127,G,7,8,811,817,24,0.49999999999999917,3.0011411045041743,kept,,1628,-6,0.808447232576699
128,G,7,9,916,818,24,0.5416666666666657,4.107459725866334,kept,,1734,98,0.8075420997868494
129,G,7,10,1018,814,23,,0,backfilled,,1832,204,0.8051398611995031
130,G,7,11,1159,820,24,0.42361111111111055,6.0,kept,,1979,339,0.8011152529017792
131,G,7,12,1263,820,26,0.361842105263158,6.324555320336759,kept,,2083,443,0.7969290137487247
132,G,7,13,1368,814,23,,0,backfilled,,2182,554,0.793506480387106
133,G,7,14,1473,823,25,0.35416666666666635,9.055385138137417,kept,,2296,650,0.795987514016426
134,G,7,15,1581,814,23,0.3088235294117645,1.0,kept,,2395,767,0.7940358214383127
135,G,7,16,1685,817,24,0.3402777777777775,3.1622776601683795,kept,,2502,868,0.7964986715964079
136,G,7,17,1794,816,23,0.3455882352941173,3.605551275463989,kept,,2610,978,0.7957390065763557
137,G,7,18,1902,816,21,0.359375,5.385164807134504,kept,,2718,1086,0.7954884787505936
138,G,7,19,2006,817,22,0.421875,5.0,kept,,2823,1189,0.7924902263842168
139,G,7,20,2109,812,24,0.3402777777777775,2.23606797749979,kept,,2921,1297,0.7922780858865959
140,H,8,1,72,928,24,0.38194444444444403,9.024033265308004,kept,,1000,-856,0.7964966512107162
141,H,8,2,179,929,23,0.4485294117647052,8.10912219881453,kept,,1108,-750,0.7986362396581509
142,H,8,3,286,933,22,0.4296875,5.1918306390773665,kept,,1219,-647,0.8018506732935319
143,H,8,4,390,931,22,0.4609375,6.42353268646194,kept,,1321,-541,0.8082835813356772
144,H,8,5,490,931,21,0.3515625,6.588629711788293,kept,,1421,-441,0.8095180369932621
145,H,8,6,602,933,23,0.41176470588235237,4.5950692711289305,kept,,1535,-331,0.8080370942812984
146,H,8,7,707,936,24,0.4791666666666659,3.3962767880798905,kept,,1643,-229,0.8096190562778437
147,H,8,8,808,937,25,0.4791666666666659,0.7702747984840244,kept,,1745,-129,0.8071764099766646
148,H,8,9,909,938,22,0.40625,5.872195040947979,kept,,1847,-29,0.8061844006020752
149,H,8,10,1018,940,23,0.7499999999999982,3.2303718302890285,kept,,1958,78,0.805277247426534
150,H,8,11,1161,939,21,0.453125,2.8284271247461903,kept,,2100,222,0.8025376044286856
151,H,8,12,1261,940,24,0.31249999999999983,3.0,kept,,2201,321,0.7975815983271208
152,H,8,13,1370,937,28,0.4047619047619044,2.0,kept,,2307,433,0.7953430109807963
153,H,8,14,1474,941,23,0.3897058823529407,4.47213595499958,kept,,2415,533,0.7952844197957392
154,H,8,15,1581,937,27,0.3874999999999996,1.0,kept,,2518,644,0.7960844925296241
155,H,8,16,1678,939,22,0.2890625,6.324555320336759,kept,,2617,739,0.7931832186764456
156,H,8,17,1793,937,24,0.562499999999999,2.0,kept,,2730,856,0.7967390974937116
157,H,8,18,1895,939,28,0.3095238095238095,2.8284271247461903,kept,,2834,956,0.7953510925235628
158,H,8,19,2005,941,21,0.4140625,5.0,kept,,2946,1064,0.7921245365740321
159,H,8,20,2108,933,22,0.3046875,4.0,kept,,3041,1175,0.7921952500732391
160,I,9,1,70,1058,23,,0,backfilled,,1128,-988,0.7942196765362508
161,I,9,2,175,1058,23,,0,backfilled,,1233,-883,0.7971249911608127
162,I,9,3,280,1058,23,,0,backfilled,,1338,-778,0.7989231344263621
163,I,9,4,380,1050,20,0.40833333333333377,9.761851852201813,kept,,1430,-670,0.8013273933994001
164,I,9,5,493,1053,26,0.4144736842105266,5.541816975145346,kept,,1546,-560,0.8035296138032753
165,I,9,6,599,1058,23,0.41176470588235237,1.3736246190069323,kept,,1657,-459,0.8042993807517856
166,I,9,7,703,1058,24,0.5208333333333325,1.3577825024406138,kept,,1761,-355,0.8046751724904286
167,I,9,8,815,1060,20,0.4000000000000004,8.578194915118212,kept,,1875,-245,0.8037074077441386
168,I,9,9,915,1059,25,0.38888888888888845,2.5315227408252454,kept,,1974,-144,0.8004404440807752
169,I,9,10,1015,1060,23,0.4779411764705874,2.023898313179835,kept,,2075,-45,0.8013617399561579
170,I,9,11,1162,1058,23,0.3897058823529407,3.0,kept,,2220,104,0.802050691477003
171,I,9,12,1262,1059,25,0.5486111111111102,1.4142135623730951,kept,,2321,203,0.7981755917204596
172,I,9,13,1366,1057,26,0.4342105263157898,2.23606797749979,kept,,2423,309,0.7967451586507865
173,I,9,14,1473,1062,27,0.3874999999999996,4.123105625617661,kept,,2535,411,0.7947672010586823
174,I,9,15,1579,1059,22,0.3828125,1.4142135623730951,kept,,2638,520,0.7940681476093787
175,I,9,16,1684,1056,25,0.4027777777777773,2.0,kept,,2740,628,0.7947227525734664
176,I,9,17,1788,1057,23,0.3455882352941173,3.1622776601683795,kept,,2845,731,0.7943510016062068
177,I,9,18,1897,1054,28,0.35714285714285693,4.0,kept,,2951,843,0.794001474881555
178,I,9,19,2002,1055,26,0.4671052631578952,3.0,kept,,3057,947,0.7918275398773627
179,I,9,20,2102,1056,20,0.4000000000000004,6.324555320336759,kept,,3158,1046,0.7917204594357065
180,J,10,1,68,1177,23,,0,backfilled,,1245,-1109,0.7940843106949117
181,J,10,2,173,1169,25,0.45833333333333265,8.014684461473173,kept,,1342,-996,0.7958925558889193
182,J,10,3,277,1170,24,0.3680555555555552,7.159106429397934,kept,,1447,-893,0.7978543503954907
183,J,10,4,385,1172,22,0.3515625,5.215313918361899,kept,,1557,-787,0.7984220787748383
184,J,10,5,492,1174,25,0.46527777777777707,4.584824869451198,kept,,1666,-682,0.7996383509611987
185,J,10,6,596,1173,24,0.36111111111111077,4.025319889795637,kept,,1769,-577,0.8016951035952765
186,J,10,7,702,1175,23,0.41176470588235237,3.1510172276473982,kept,,1877,-473,0.8010990898162461
187,J,10,8,809,1180,22,0.40625,5.341070834116117,kept,,1989,-371,0.8000484892565992
188,J,10,9,908,1178,23,0.39705882352941124,2.7830700576888483,kept,,2086,-270,0.7978139426816582
189,J,10,10,1012,1177,23,,0,backfilled,,2189,-165,0.7978341465385744
190,J,10,11,1161,1179,22,0.4765625,2.8284271247461903,kept,,2340,-18,0.8014829630976555
191,J,10,12,1259,1177,27,0.3624999999999997,2.0,kept,,2436,82,0.7976987806972352
192,J,10,13,1370,1180,26,0.3421052631578948,3.605551275463989,kept,,2550,190,0.7953389702094131
193,J,10,14,1470,1183,23,0.31617647058823506,6.324555320336759,kept,,2653,287,0.7955329272358095
194,J,10,15,1580,1179,24,0.36111111111111077,2.0,kept,,2759,401,0.7948783222717217
195,J,10,16,1686,1177,25,0.45138888888888823,2.0,kept,,2863,509,0.7936660908567448
196,J,10,17,1789,1176,28,0.3749999999999997,2.23606797749979,kept,,2965,613,0.7955450495499593
197,J,10,18,1896,1180,26,0.30263157894736836,3.1622776601683795,kept,,3076,716,0.7936802335565861
198,J,10,19,2006,1175,28,0.30357142857142855,4.47213595499958,kept,,3181,831,0.7910739360143852
199,J,10,20,2112,1178,26,0.44736842105263197,4.123105625617661,kept,,3290,934,0.7926922649533796
